16x10
1x1
MMMMMMMMMMMMMMMM
MGGGFFFFGGGGGGGM
MGGFGGFFGGGGGGGM
MGGGBGBGGGGGGGGM
MSGGWWWWGGGGGGGM
MGGGBWWMWGBGGGSM
MGGGWWMMWWWGGGGM
MGGGGWWWWGBFFFFM
MGGGGGGGGFFFFFFM
MMMMMMMMMMMMMMMM
