16x10
1x1
MMMMMMMMMMMMMMMM
MGGGFFFFGGGGGGGM
MGGFGGFFGGGGGGGM
MGGGBGBGGGGGSGGM
MGSGWWWWGGGGGGGM
MGGGBWWMWGBGGGGM
MGGGWWMMWWWGGGGM
MGGGGWWWWGBFFFFM
MGGGGGGGGFFFFFFM
MMMMMMMMMMMMMMMM