32x16
3x3
MMMMMMMMMMMMMMMMMMMMMMMMMMMMMMMM
MGGGFFFFGGGGGGGGGGGGGGGGGGGGGGGM
MGGFGGFFGGGGGGGMMMMMMMMMGGGGGGGM
MGGGGGGGGGGGGGGMMMMMMMMGGGGGGGGM
MSGGWWWWGGGGGGGWWMMMGGGGGGGGGGGM
MGGGGWWWGGGGGWWWMMMGGGGGGGGGGGGM
MGGGWWWWWWWWWFFFFFFFFFFFFFGGGGSM
MSGGGWWWWWFFFFFFFGGFFFFFFGGGGGGM
MGGGGGGGGFFFFFFFGGGFFFGGGGGGGGSM
MSGGGGGGGGGGGGGGGGGGGGGGGGGGGGGM
MGGGGGGGGGGGGGGGGGGGGGGGGGGGGGGM
MGGGGGGGGGGGGGGGGGGGGGGGGGGGGGSM
MGGGGGGGBBBBGGGGGGGFFFFGGGGGGGGM
MGGGGBBBBBBFFFFFWWWGGGGGGGGGGGGM
MBBBBBBBBBBBBBBBGWWGGGGGGGGGGGGM
MMMMMMMMMMMMMMMMMMMMMMMMMMMMMMMM
