32x16
3x3
MMMMMMMMMMMMMMMMMMMMMMMMMMMMMMMM
MGGGFFFFGGGGGGGGGGGGGGGGGSGGGGGM
MGGFGGFFGGGGGGGMMMMMMMMMGGGGGGGM
MGGGGGGGGGGGGGGMMMMMMMMGGGGGGGGM
MSGGWWWWGGGGGGGWWMMMGGGGGGGGGGGM
MGGGGWWWGGGGGWWWMMMGGGGGGGGGGGGM
MGGGWWWWWWWWWFFFFFFFFFFFFFGGGGGM
MSGGGWWWWWFFFFFFFGGFFFFFFGGGGGGM
MGGGGGGGGFFFFFFFGGGFFFGGGSGGGGGM
MGGGGGGGGGGGGGGGGGGGGGGGGGGGGGGM
MGGGGGSGGGGGGGGGSGGGGGGGGGGGGGGM
MGGGGGGGGGGGGGGGGGGGGGGGGGGGGGGM
MGGGGGGGBBBBGGGGGGGFFFFGGGGGGGGM
MGGGGBBBBBBFFFFFWWWGGGGGGGGGGGGM
MBBBBBBBBBBBBBBBGWWGGGGGGGGGGGGM
MMMMMMMMMMMMMMMMMMMMMMMMMMMMMMMM
