16x10
MMMMMMMMMMMMMMMM
MGGGFFFFGGGGGGGM
MGGFGGFFGGGGGGGM
MGGGBGBGGGGGGGGM
MGGGWWWWGGGGGGGM
MGGGBWWMWGBGGGGM
MGGGWWMMWWWGGGGM
MGGGGWWWWGBFFFFM
MGGGGGGGGFFFFFFM
MMMMMMMMMMMMMMMM