32x16
MMMMMMMMMMMMMMMMMMMMMMMMMMMMMMMM
MGGGFFFFGGGGGGGGGGGGGGGGGEGGGGGM
MGGFGGFFGGGGGGGMMMMMMMMMGGGGGGGM
MGGGGGGGGGGGGGGMMMMMMMMGGGGGGGGM
MPGGWWWWGGGGGGGWWMMMGGGGGGGGGGGM
MGGGGWWWGGGGGWWWMMMGGGGGGGGGGGGM
MGGGWWWWWWWWWFFFFFFFFFFFFFGGGGGM
MPGGGWWWWWFFFFFFFGGFFFFFFGGGGGGM
MGGGGGGGGFFFFFFFGGGFFFGGGEGGGGGM
MGGGGGGGGGGGGGGGGGGGGGGGGGGGGGGM
MGGGGGPGGGGGGGGGEGGGGGGGGGGGGGGM
MGGGGGGGGGGGGGGGGGGGGGGGGGGGGGGM
MGGGGGGGBBBBGGGGGGGFFFFGGGGGGGGM
MGGGGBBBBBBFFFFFWWWGGGGGGGGGGGGM
MBBBBBBBBBBBBBBBGWWGGGGGGGGGGGGM
MMMMMMMMMMMMMMMMMMMMMMMMMMMMMMMM